######################################################
#                                                    #
#                                                    #
#                                                    #
#                                                    #
#          ######    ######   ######   ######        #
#         ##        ##          ##       ##          #
#         ##        ##          ##       ##          #
#          #####     #####      ##       ##          #
#              ##        ##     ##       ##          #
#              ##        ##     ##       ##          #
#         ######  # ######  # ###### # ###### #      #
#                                                    #
#                                                    #
#                                                    #
######################################################
