#######################################
#              #                      #
#              #                      #
#              #                      #
#              #                      #
#              #                      #
#              #                      #
#  ##########  #                      #
#       #      #                      #
#       #      #                      #
#       #      #                      #
############   #                      #
#              #                      #
#              #                      #
#              #                      #
#              #   #####              #
#              #       #              #
#              #       #              #
#              #####   #              #
#                      #              #
#                      #              #
#                      #              #
#                      #  ########    #
#                      #     #        #
#                      #     #        #
#                      #     #        #
#                      #     #        #
#                      #     #        #
#                      #  ########    #
#                      #              #
#                      #              #
#                      #              #
#######################################
