##################################################
#                                                #
#                                                #
#                                                #
#                                                #
#                       #                        #
#                       #                        #
#                       #                        #
#                       #                        #
#                       #                        #
#                       #                        #
#                       #                        #
#                       #                        #
#                       #                        #
#                                                #
#                                                #
#                                                #
#                                                #
#                                                #
#                       #                        #
#                       #                        #
#                       #                        #
#                                                #
#                                                #
#                                                #
#                                                #
#                                                #
#                       #                        #
#                       #                        #
#                       #                        #
#                                                #
#                                                #
#                                                #
#                                                #
#                                                #
##################################################