########################################
#                                      #
#  ##################################  #
#  #               ##               #  #
#  #  ####  #####  ##  #####  ####  #  #
#  #  #  #  #   #  ##  #   #  #  #  #  #
#  #  ####  #####  ##  #####  ####  #  #
#  #                                #  #
#  #                                #  #
#  #  ####  ## ########## ##  ####  #  #
#  #  ####  ## ########## ##  ####  #  #
#  #        ##     ##     ##        #  #
#  #        ##     ##     ##        #  #
#  #######  #####  ##  #####  #######  #
#        #  #####  ##  #####  #        #
#        #  ##            ##  #        #
#        #  ##            ##  #        #
#        #  ## ####  #### ##  #        #
#  #######  ## #        # ##  #######  #
#              #        #              #
#              #        #              #
#  #######  ## #        # ##  #######  #
#        #  ## ########## ##  #        #
#        #  ##            ##  #        #
#        #  ##            ##  #        #
#        #  ## ########## ##  #        #
#  #######  ## ########## ##  #######  #
#  #               ##               #  #
#  #               ##               #  #
#  #  ####  #####  ##  #####  ####  #  #
#  #  ####  #####  ##  #####  ####  #  #
#  #    ##                    ##    #  #
#  #    ##                    ##    #  #
#  #### ##  ## ########## ##  ## ####  #
#  #### ##  ## ########## ##  ## ####  #
#  #        ##     ##     ##        #  #
#  #        ##     ##     ##        #  #
#  #  ####  #####  ##  ##### #####  #  #
#  #  ####  #####  ##  ##### #####  #  #
#  #                                #  #
#  ##################################  #
#                                      #
#                                      #
########################################