######################################################
#                #                                   #
#                #                                   #
#                #                                   #
#                #                                   #
#                #                                   #
#                #                                   #
#                #                                   #
#                #                                   #
#                #                                   #
#                #                                   #
#                #                                   #
#                #                                   #
#                #                                   #
#                #                                   #
#                #                                   #
#                #                                   #
#                #   ########                        #
#                #          #                        #
#                #          #                        #
#                #          #                        #
#                #          #                        #
#                ########   #                        #
#                           #                        #
#                           #                        #
#                           #                        #
#                           #                        #
#                           #                        #
#                           #                        #
#                           #                        #
#                           #                        #
#                           #                        #
#                           #                        #
#                           #                        #
#                           #                        #
#                           #                        #
#                           #                        #
#                           #                        #
#                           #                        #
######################################################
