##################################################
#                                                #
#    ####################                        #
#    #                  #                        #
#    #   #############  #                        #
#    #         #     #  #                        #
#    #         ###   #  #                        #
#    #               #  #                        #
#    #################  #                        #
#                       #                        #
#########################                        #
#                             #################  #
#    ################                            #
#               ##  #     #     ##         ##    #
#              ##   #     #      ##       ##     #
#             ##    #     #       ##     ##      #
#            ##     #     #        ##   ##       #
#           ##      #     #         #####        #
#          ##       #     #          ###         #
#          #        ##                           #
#          #  ###### #                           #
#          #  #      #    ########################
#          #  #      #    #    ##                #
#          #  #      #    #   #  ############### #
#          #  #      ######                   ## #
#             #          ####                ##  #
#   ###     ###             ##               ##  #
#  #          #              ##             ##   #
# #            #             ##            ##    #
# #             #       ##    ##          ##     #
# #             #       #     ##         ##      #
# #             #       #      ##       ##       #
#  #            #       #       ##     ##        #
#   #           #       #        ##   ##         #
#    #         #        #         #####          #
#     #       #         #          ###           #
#      #     #          #                        #
##################################################